111111111111111111111
1P10001000100000000M1
1010101010100M00M0101
1000100010M0000000101
111111111111111111101
10C0000C00000C0000C01
1E00C00000C00000C0001
111111111111111111111
