1111111111111111
1P000000000000C1
100111M111M11101
1000010000000001
101101M1111111M1
100M010000000001
1001110111M11101
1C0000M0000M00E1
1111111111111111
