11111111111111111111111111111111111111111111111111
1P000000000000M00000M00000000000000000M000000M00M1
11111111111111C11111C11111111111111111C111111C11C1
1M00000M000000000000M000000M0000000000M000M00000M1
1C11111C111111111111C111111C1111111111C111C11111C1
100000M010000M00000M000000M000000M000000M000000M01
111111C111111C11111C111111C111111C111111C111111C11
1000M0001M0000000000M000000M000000000000M000M00001
1111C1111C1111111111C111111C111111111111C111C11111
100000M010000000000M000000M0000000000000M0000M0001
111111C111111111111C111111C1111111111111C1111C1111
1M00000M100000M000000M000000M000000M000000M00000M1
1C11111C111111C111111C111111C111111C111111C11111C1
1M00000M000000M000000M000000M000000M000000M10000M1
10000M001000M000000M000000M000000M000000M000000M01
11111C111111C111111C111111C111111C111111C111111C11
1000M0010M0000000000M000000M000000000000M000M00001
1111C1111C1111111111C111111C111111111111C111C11111
100000M010000000000M000000M0000000000000M0000M0001
111111C111111111111C111111C1111111111111C1111C1111
1M00000M10000M000000M00000M000000M000000M000000M01
1C11111C11111C111111C11111C111111C111111C111111C11
1M00000M00000M000000M00000M000000M000000M100000M01
100000M010000M000000M000000M000000M000000M00000M01
111111C111111C111111C111111C111111C111111C11111C11
1000M0001M0000000000M000000M000000000000M000M00001
1111C1111C1111111111C111111C111111111111C111C11111
100000M010000000000M000000M0000000000000M0000M0001
111111C111111111111C111111C1111111111111C1111C1111
1M00000M10000M000000M000000M00000M000000M000000M01
1C11111C11111C111111C111111C11111C111111C111111C11
1M00000M00000M000000M000000M00000M000000M000000ME1
11111111111111111111111111111111111111111111111111
