111111111111111111
1000000000P
1000C
1000000000E
11111111111111
