1111111
1P00C01
10011M1
1C00001
11ME1M1
1111111
