111111111111111111111
1P1000100010000000001
1010101010100C00C0101
100010001000000000101
111111111111111111101
10C1000C10000C0000C01
1C01C0E010C00000C0001
111111111111000011111
